10 10
9 0
0 9
0 1 2 3 3 X 0 1 2 2
2 1 2 4 3 0 1 3 3 3
2 2 X 4 5 3 2 X X X
X 3 X X 6 4 2 3 3 3
2 2 3 3 5 3 3 2 3 3
2 1 1 3 4 0 2 2 3 4
2 0 0 X X 1 1 1 1 X
X 1 2 1 2 0 2 3 2 3
2 2 2 1 1 X 2 3 3 4
4 3 2 2 X 1 1 2 4 5