15 15
0 14
14 0
0 1 2 3 3 X 0 1 2 2 4 2 3 1 0
2 1 2 4 3 2 1 3 3 3 X X 2 0 2
2 2 X 4 5 3 2 X 4 4 1 0 2 3 3
3 3 X 4 6 4 2 3 3 3 X 1 3 2 1
2 2 3 3 5 3 3 2 3 3 1 2 1 1 3
2 1 1 3 4 X 2 2 3 4 X 3 3 1 2
2 0 0 1 2 1 1 1 1 X 0 1 2 3 1
X 1 0 1 2 0 2 3 2 3 3 X 2 2 3
2 2 2 1 1 0 2 3 3 4 1 2 1 2 1
4 3 2 2 X 1 1 2 4 5 X 3 3 4 1
2 3 4 4 1 5 5 3 2 1 X X 2 2 4
3 4 2 2 3 1 2 3 3 X 1 2 3 1 1
3 1 X X X 3 2 1 1 4 3 3 1 2 2
1 X 2 2 1 0 3 5 4 2 1 2 3 3 4
5 2 1 3 1 3 2 1 X X 3 2 1 X 3